#############
#@          #
# # # # # # #
#  . . . .  #
# # # # # # #
#   . . .   #
# # # # # # #
#  . . . .  #
# # # # # # #
#          X#
#############
