#############
#@          #
#  .#.# #.# #
#  ... . .. #
# # # #.#.# #
# ..  ...   #
# # #.#.# # #
# . ..   X  #
# # #.#.#.# #
#           #
#############
