#############
#@          #
#   #.# # # #
# ... .  .  #
# #.# # #.# #
# .   .X. . #
# #.# #.#.# #
#  . ...    #
# #.# #.#.# #
#           #
#############
